111111111111111111111
100E00000000000111101
100000000000001000001
100000000000000101101
100C00000000000101001
100000000000000101P01
100000000000000001001
111111111111111111111
