1111111111111111111111111111
100C1C00000E0011110101100C11
10011111000001C00000000000C1
10001C10000101101001C0000001
10000011001C1010001000001111
10111111010010100000P0100001
10100000C100000C001001111011
1010011111110000001001110011
1010000100C10000010111110011
10110001001C0010000011110011
1011110101111000010011110011
1C00000000000000010C11110C11
1111111111111111111111111111
