111111111
100000001
10CCECCC1
1CCCCCCC1
10CCCCP01
10CCCCC01
100000001
111111111
