111111111
1C00E0CP1
1C0C000C1
1000000C1
1C0CCC001
1CCCCCCC1
111111111
