111111111
1C00E0CP1
1C0C000C1
1000000C1
100000001
100000001
111111111
