111111111
1CCC0CC01
10CCECCC1
1CCCCCCC1
100000P01
100000001
100000001
111111111
