1111111111111111111111111
100000000000E0000000000C1
1000000000000000000000001
1000000000000000000000001
1000000000000000000000001
1000000000000000000000001
1000000000000000000000001
1000000000000000000000001
10000000000000000000000P1
1111111111111111111111111
