111111
100001
100001
1ECP01
111111
