11111
10PC1
10E01
10001
11111
