111111111
100000001
10CCECCC1
10CCCCCC1
10CCCCPC1
10CCCCCC1
10CCCCCC1
111111111
