11111111111111111111111111111
1000001C001C00110000000C10P01
100110011001000001C1111111001
1C10101C000010100010000100101
11100000110000110000100001101
10010100000100011000110000001
10100001001110001100010001101
1C0111C0010011100000111001C01
1000001000101C0011100C0000111
1E0000011110011100000110000C1
100C0111100000100000001101001
11010010000110000010000001011
110010000000000001101C0010001
111000011C001100000000001C001
11111111111111111111111111111
