1111111111111111111111111
1C0000010000E0000000000C1
1000000100000000000000001
1000000100000000000000001
1000000100000000011111111
10000000000000000000000C1
1111100000000010000000001
1000000000000010000000001
1C000000000000100000000P1
1111111111111111111111111
